55555555555555555555555555555555555555555555555555555555555555555555555555555555555555555555555555555555
55555555555555555555555555555555555555555555555555555555555555555555555555555555555555555555555555555555
55133121211111112111111111111111111111111111111111111111111111111111111111111111111111111111111111111155
55132111331111111211121111111111111111111111111111111111111111111111111111111111111111111111111111111155
55111111111111112111111112111111111111111111111111111111111111111111111111111111111111111111111111111155
55111111111111111121121111111111211111111111111111111111111111111111111111111111111111111111111111111155
55111111111111111111111111111111111111111111111111111111111111111111111111111111111111111111111111111155
55111111111111112111111112111111111111111111111111111111111111111111111111111111111111111111111111111155
55111111111111111121121111111111211111111111111111111111111111111111111111111111111111111111111111111155
55111111111111111111111111111111111111111111111111111111111111111111111111111111111111111111111111111155
55111111111111112111111112111111111111111111111111111111111111111111111111111111111111111111111111111155
55111111111111111121121111111111211111111111111111111111111111111111111111111111111111111111111111111155
55111111111111111111111111111111111111111111111111111111111111111111111111111111111111111111111111111155
55111111111111112111111112111111111111111111111111111111111111111111111111111111111111111111111111111155
55111111111111111121121111111111211111111111111111111111111111111111111111111111111111111111111111111155
55111111111111111111111111111111111111111111111111111111111111111111111111111111111111111111111111111155
55111111111111112111111112111111111111111111111111111111111111111111111111111111111111111111111111111155
55111111111111111121121111111111211111111111111111111111111111111111111111111111111111111111111111111155
55111111111111111111111111111111111111111111111111111111111111111111111111111111111111111111111111111155
55111111111111112111111112111111111111111111111111111111111111111111111111111111111111111111111111111155
55111111111111111121121111111111211111111111111111111111111111111111111111111111111111111111111111111155
55111111111111111111111111111111111111111111111111111111111111111111111111111111111111111111111111111155
55111111111111112111111112111111111111111111111111111111111111111111111111111111111111111111111111111155
55111111111111111121121111111111211111111111111111111111111111111111111111111111111111111111111111111155
55111111111111111111111111111111111111111111111111111111111111111111111111111111111111111111111111111155
55111111111111112111111112111111111111111111111111111111111111111111111111111111111111111111111111111155
55111111111111111121121111111111211111111111111111111111111111111111111111111111111111111111111111111155
55111111111111111111111111111111111111111111111111111111111111111111111111111111111111111111111111111155
55111111111111112111111112111111111111111111111111111111111111111111111111111111111111111111111111111155
55111111111111111121121111111111211111111111111111111111111111111111111111111111111111111111111111111155
55111111111111111111111111111111111111111111111111111111111111111111111111111111111111111111111111111155
55111111111111112111111112111111111111111111111111111111111111111111111111111111111111111111111111111155
55111111111111111121121111111111211111111111111111111111111111111111111111111111111111111111111111111155
55111111111111111111111111111111111111111111111111111111111111111111111111111111111111111111111111111155
55111111111111112111111112111111111111111111111111111111111111111111111111111111111111111111111111111155
55111111111111111121121111111111211111111111111111111111111111111111111111111111111111111111111111111155
55111111111111111111111111111111111111111111111111111111111111111111111111111111111111111111111111111155
55111111111111112111111112111111111111111111111111111111111111111111111111111111111111111111111111111155
55111111111111111121121111111111211111111111111111111111111111111111111111111111111111111111111111111155
55111111111111111111111111111111111111111111111111111111111111111111111111111111111111111111111111111155
55111111111111112111111112111111111111111111111111111111111111111111111111111111111111111111111111111155
55111111111111111121121111111111211111111111111111111111111111111111111111111111111111111111111111111155
55111111111111111111111111111111111111111111111111111111111111111111111111111111111111111111111111111155
55111111111111112111111112111111111111111111111111111111111111111111111111111111111111111111111111111155
55111111111111111121121111111111211111111111111111111111111111111111111111111111111111111111111111111155
55111111111111111111111111111111111111111111111111111111111111111111111111111111111111111111111111111155
55111111111111112111111112111111111111111111111111111111111111111111111111111111111111111111111111111155
55111111111111111121121111111111211111111111111111111111111111111111111111111111111111111111111111111155
55111111111111111111111111111111111111111111111111111111111111111111111111111111111111111111111111111155
55111111111111112111111112111111111111111111111111111111111111111111111111111111111111111111111111111155
55111111111111111121121111111111211111111111111111111111111111111111111111111111111111111111111111111155
55111111111111111111111111111111111111111111111111111111111111111111111111111111111111111111111111111155
55111111111111112111111112111111111111111111111111111111111111111111111111111111111111111111111111111155
55111111111111111121121111111111211111111111111111111111111111111111111111111111111111111111111111111155
55111111111111111111111111111111111111111111111111111111111111111111111111111111111111111111111111111155
55111111111111112111111112111111111111111111111111111111111111111111111111111111111111111111111111111155
55111111111111111121121111111111211111111111111111111111111111111111111111111111111111111111111111111155
55111111111111111111111111111111111111111111111111111111111111111111111111111111111111111111111111111155
55111111111111112111111112111111111111111111111111111111111111111111111111111111111111111111111111111155
55111111111111111121121111111111211111111111111111111111111111111111111111111111111111111111111111111155
55111111111111111111111111111111111111111111111111111111111111111111111111111111111111111111111111111155
55111111111111112111111112111111111111111111111111111111111111111111111111111111111111111111111111111155
55111111111111111121121111111111211111111111111111111111111111111111111111111111111111111111111111111155
55111111111111111111111111111111111111111111111111111111111111111111111111111111111111111111111111111155
55111111111111112111111112111111111111111111111111111111111111111111111111111111111111111111111111111155
55111111111111111121121111111111211111111111111111111111111111111111111111111111111111111111111111111155
55111111111111111111111111111111111111111111111111111111111111111111111111111111111111111111111111111155
55111111111111112111111112111111111111111111111111111111111111111111111111111111111111111111111111111155
55111111111111111121121111111111211111111111111111111111111111111111111111111111111111111111111111111155
55111111111111111111111111111111111111111111111111111111111111111111111111111111111111111111111111111155
55111111111111112111111112111111111111111111111111111111111111111111111111111111111111111111111111111155
55111111111111111121121111111111211111111111111111111111111111111111111111111111111111111111111111111155
55111111111111111111111111111111111111111111111111111111111111111111111111111111111111111111111111111155
55111111111111112111111112111111111111111111111111111111111111111111111111111111111111111111111111111155
55111111111111111121121111111111211111111111111111111111111111111111111111111111111111111111111111111155
55111111111111111111111111111111111111111111111111111111111111111111111111111111111111111111111111111155
55111111111111112111111112111111111111111111111111111111111111111111111111111111111111111111111111111155
55111111111111111121121111111111211111111111111111111111111111111111111111111111111111111111111111111155
55111111111111111111111111111111111111111111111111111111111111111111111111111111111111111111111111111155
55111111111111112111111112111111111111111111111111111111111111111111111111111111111111111111111111111155
55111111111111111121121111111111211111111111111111111111111111111111111111111111111111111111111111111155
55111111111111111111111111111111111111111111111111111111111111111111111111111111111111111111111111111155
55111111111111112111111112111111111111111111111111111111111111111111111111111111111111111111111111111155
55111111111111111121121111111111211111111111111111111111111111111111111111111111111111111111111111111155
55111111111111111111111111111111111111111111111111111111111111111111111111111111111111111111111111111155
55111111111111112111111112111111111111111111111111111111111111111111111111111111111111111111111111111155
55111111111111111121121111111111211111111111111111111111111111111111111111111111111111111111111111111155
55111111111111111111111111111111111111111111111111111111111111111111111111111111111111111111111111111155
55111111111111112111111112111111111111111111111111111111111111111111111111111111111111111111111111111155
55111111111111111121121111111111211111111111111111111111111111111111111111111111111111111111111111111155
55111111111111111111111111111111111111111111111111111111111111111111111111111111111111111111111111111155
55111111111111112111111112111111111111111111111111111111111111111111111111111111111111111111111111111155
55111111111111111121121111111111211111111111111111111111111111111111111111111111111111111111111111111155
55111111111111111111111111111111111111111111111111111111111111111111111111111111111111111111111111111155
55111111111111112111111112111111111111111111111111111111111111111111111111111111111111111111111111111155
55111111111111111121121111111111211111111111111111111111111111111111111111111111111111111111111111111155
55111111111111111111111111111111111111111111111111111111111111111111111111111111111111111111111111111155
55111111111111112111111112111111111111111111111111111111111111111111111111111111111111111111111111111155
55111111111111111121121111111111211111111111111111111111111111111111111111111111111111111111111111111155
55111111111111111111111111111111111111111111111111111111111111111111111111111111111111111111111111111155
55555555555555555555555555555555555555555555555555555555555555555555555555555555555555555555555555555555
55555555555555555555555555555555555555555555555555555555555555555555555555555555555555555555555555555555
