55555555555555555555555555555555555555555555555555555555555555555555555555555555555555555555555555555555
55555555555555555555555555555555555555555555555555555555555555555555555555555555555555555555555555555555
55333333111111121111133333311111111131111111111111111111111111111111111111111888888888888888888888888855
55333333211111222111133333311111212191111111111111111111111111111111111111111888888888888888888888888855
55333344111112222211133333311112221131111111111111111111111111111111111111111888888888888888888888888855
55333344444411122111233334411112222191111111111111111111111111111111111111111888888888888888888888888855
55111144444411112111133334411111211131111111111111111111111111111111111111111888888888888888888888888855
55111212114411118888111114411111111191111111111111111111111111111111111111111888888888888888888888888855
55111222214444448888444444411111111131111111111111111111111111111111111111111888888888888888888888888855
55112211194444448888444444443333311191111111111111111111111111111111111111111888888888888888888888888855
55122211134421118888122211443333331131111111111111111111111111111111111111111888888888888888888888888855
55112441114411111111122222441333333191111111111111111111111111111111111111111888888888888888888888888855
55121111114411111111121221441134433131111111111111111111111111111111111111111888888888888888888888888855
55122111114411111111111112444444411191111111111111111111111111111111111111111888888888888888888888888855
55112221114411111111111111111111111131111111111111111111111111111111111111111888888888888888888888888855
55122221114411113333311111111111111911111111111111111111111111111111111111111888888888888888888888888855
55112211194411113333331111111222111131111111111111111111111111111111111111111888888888888888888888888855
55111111134411111333333111112222111191111111111111111111111111111111111111111888888888888888888888888855
5511111119444444413443311111122211131111111111111111111111111111111111111111888888888888888888888888855
5511111113444444444441111111111221191111111111111111111111111111111111111111888888888888888888888888855
55111111194411711111111111111112221131111111111111111111111111111111111111111888888888888888888888888855
55111111134411111111112221111111222191111111111111111111111111111111111111111888888888888888888888888855
55333333114411111111111222211111122131111111111111111111111111111111111111111888888888888888888888888855
55333333114491122211111122111111111191111111111111111111111111111111111111111888888888888888888888888855
55333344114431222211111111111211121131111111111111111111111111111111111111111888888888888888888888888855
55333344444491122111122111112222111191111111111111111111111111111111111111111888888888888888888888888855
55111144444431111211221111122222211131111111111111111111111111111111111111111888888888888888888888888855
55111111114411111111112111111122111191111111111111111111111111111111111111111888888888888888888888888855
55737373731117373737373737373737373731111111111111111111111111111111111111111888888888888888888888888855
55111111111111111111111111111111111111111111111111111111111111111111111111111888888888888888888888888855
55111111111111111111111111111111111111111111111111111111111111111111111111111888888888888888888888888855
55111111111111111111111111111111111111111111111111111111111111111111111111111888888888888888888888888855
55111111111111111111111111111111111111111111111111111111111111111111111111111888888888888888888888888855
55111111111111111111111111111111111111111111111111111111111111111111111111111888888888888888888888888855
55555555555555555555555555555555555555555555555555555555555555555555555555555555555555555555555555555555
55555555555555555555555555555555555555555555555555555555555555555555555555555555555555555555555555555555
