55555555555555555555555555555555555555555555555555555555555555555555555555555555555555555555555555555555
55555555555555555555555555555555555555555555555555555555555555555555555555555555555555555555555555555555
55333333111111441111111111111111111111111111111111111111111111111111111111111111111111111111111111111155
55333333211214411111111112111111111111111111111111111111111111111111111111111111111111111111111111111155
55333333444444111111111111111111111111111111111111111111111111111111111111111111111111111111111111111155
55333346642444411111111111111111111111111111111111111111111111111111111111111111111111111111111111111155
55333346642422441111211111111111111211111111111111111111111111111111111111111111111111111111111111111155
55444412442444441111111111111111111111111111111111111111111111111111111111111111111111111111111111111155
55444444444444411111111111111111111111111111111111111111111111111111111111111111111111111111111111111155
55444444411141111111111111111111111111111111111111111111111111111111111111111111111111111111111111111155
55444444111244111111111111111111111111111111111111111111111111111111111111111111111111111111111111111155
55111441111114111111111111111111111111111111111111111111111111111111111111111111111111111111111111111155
55111111111111111111111111111111111111111111111111111111111111111111111111111111111111111111111111111155
55111111111111111111111111111111111111111111111111111111111111111111111111111111111111111111111111111155
55111111111111111111111111111111111111111111111111111111111111111111111111111111111111111111111111111155
55111111111111111111111111111111111111111111111111111111111111111111111111111111111111111111111111111155
55111111111111111111111111111111111111111111111111111111111111111111111111111111111111111111111111111155
55111111111111111111111111111111111111111111111111111111111111111111111111111111111111111111111111111155
55111111111111111111111111111111111111111111111111111111111111111111111111111111111111111111111111111155
55111111111111111111111111111111111111111111111111111111111111111111111111111111111111111111111111111155
55111111111111111111111111111111111111111111111111111111111111111111111111111111111111111111111111111155
55111111111111111111111111111111111111111111111111111111111111111111111111111111111111111111111111111155
55111111111111111111111111111111111111111111111111111111111111111111111111111111111111111111111111111155
55111111111111111111111111111111111111111111111111111111111111111111111111111111111111111111111111111155
55111111111111111111111111111111111111111111111111111111111111111111111111111111111111111111111111111155
55111111111111111111111111111111111111111111111111111111111111111111111111111111111111111111111111111155
55111111111111111111111111111111111111111111111111111111111111111111111111111111111111111111111111111155
55111111111111111111111111111111111111111111111111111111111111111111111111111111111111111111111111111155
55111111111111111111111111111111111111111111111111111111111111111111111111111111111111111111111111111155
55111111111111111111111111111111111111111111111111111111111111111111111111111111111111111111111111111155
55111111111111111111111111111111111111111111111111111111111111111111111111111111111111111111111111111155
55111111111111111111111111111111111111111111111111111111111111111111111111111111111111111111111111111155
55111111111111111111111111111111111111111111111111111111111111111111111111111111111111111111111111111155
55111111111111111111111111111111111111111111111111111111111111111111111111111111111111111111111111111155
55555555555555555555555555555555555555555555555555555555555555555555555555555555555555555555555555555555
55555555555555555555555555555555555555555555555555555555555555555555555555555555555555555555555555555555
