33333333333333333333333333333333333333333333333333333333333333333333333333
33333333333333333333333333333333333333333333333333333333333333333333333333
334444444444444444llll4444444444444444444444444666666666666666666666666633
334444444444444444llll4444444444444444444444444466666666666666666666666633
334444224444444444llll44444444lll44444444444444446666666666666666666666633
33444422222244444444444442244llll44444444444444446666666666666666666666633
33444422222244444444444442244llll44444444444444444666666666666666666666633
33444444442244444444444442244llllll444444444444444466666666666666666666633
33444444442222222222222222244llllllll4444444444444466666666666666666666633
334444444422222l2222222222224lllllllll444444444444466666666666666666666633
3344444444224llll4444444442244lllll444444444444444666666666666666666666633
334442244422llllll4444444422444lll4444444444444446666666666666666666666633
334444444422lllllll4444444224444444444444444444446666666666666666666666633
3344444444224lllllll444444222222444444444444444466666666666666666666666633
3344444444224llllllll44444222222224442244444444466666666666666666666666633
33444444442244ll4444444444224444222222244444444466666666666666666666666633
33444444442244444444444442244444444444444444444466666666666666666666666633
33444444442244444444444422444444444444444444444446666666666666666666666633
33lll44l442222222442244224444444444444444444444446666666666666666666666633
33llll44442222222222222244444444444444444444444466666666666666666666666633
33llll4l442244444444444444444444444444444444444466666666666666666666666633
33llllll442244444444444444444444444444444444444466666666666666666666666633
33444444442244444444444444444444444444444444444446666666666666666666666633
33444444442244444444444444444444444444444444444446666666666666666666666633
33444422442244444444444444444444444444444444444444666666666666666666666633
33444422222244444444444444444444444444444444444444446666666666666666666633
33444422222244444444444444444444444444444444444444466666666666666666666633
33444444442244444444444444444444444444444444444444446666666666666666666633
33444444442244444444444444444444444444444444444444444444666666666666666633
33444444442244444444444444444444444444444444444444444444466666666666666633
33444444442244444444444444444444444444444444444444444444466666666666666633
33444444442244444444444444444444444444444444444444444444446666666666666633
33444444442224444444444444444444444444444444444444444444444466666666666633
33444444442222244444444444444444444444444444444444444444444444466666666633
33444444444222224444444444444444444444444444444444444444444444466666666633
33444444444442222444444444444444444444444444444444444444444444666666666633
33444444444444222244444444444444444444444444444444444444444446666666666633
33444444444444422224444444444444444444444444444444444444444466666666666633
33444444444444442222444444444444444444444444444444444444444466666655555533
33444444444444444222244444444444444444444444444444444444444455555555555533
33444444444444444422224444444444444444444444444444444444444555555555555533
33444444444444444442224444444444444444444444444444444444445555555555555533
33444444444444444444444444444444444444444444444444444444455555555555555533
33444444444444444444444444444444444444444444444444444444555555555555555533
33444444444444444444444444444444444444444444444444444445555555555555555533
33444444444444444444444444444444444444444444444444444455555555555555555533
33444444444444444444444444444444444444444444444444444555555555555555555533
33444444444444444444444444444444444444444444444444455555555555555555555533
33444444444444444444444444444444444444444444444455555555555555555555555533
33444444444444444444444444444444444444444444444555555555555555555555555533
33444444444444444444444444444444444444444444445555555555555555555555555533
33444444444444444444444444444444444444444444445555555555555555555555555533
33444444444444444444444444444444444444444444455555555555555555555555555533
33444444444444444444444444444444444444444444555555555555555555555555555533
33444444444444444444444444444444444444444445555555555555555555555555555533
33444444444444444444444444444444444444444455555555555555555555555555555533
33444444444444444444444444444444444444444455555555555555555555555555555533
33444444444444444444444444444444444444444555555555555555555555555555555533
33444444444444444444444444444444444444445555555555555555555555555555555533
33444444444444444444444444444444444444455555555555555555555555555555555533
33444444444444444444444444444444444455555555555555555555555555555555555533
33444444444444444444444444444444444555555555555555555555555555555555555533
33444444444444444444444444444444444555555555555555555555555555555555555533
33444444444444444444444444444444445555555555555555555555555555555555555533
33444444444444444444444444444444555555555555555555555555555555555555555533
33444444444444444444444444444444555555555555555555555555555555555555555533
33444444444554444444444444455555555555555555555555555555555555555555555533
33444444445555444444444444555555555555555555555555555555555555555555555533
33444444455555544444444445555555555555555555555555555555555555555555555533
33444444555555554444444455555555555555555555555555555555555555555555555533
33444445555555555444444555555555555555555555555555555555555555555555555533
33444455555555555555555555555555555555555555555555555555555555555555555533
33444555555555555555555555555555555555555555555555555555555555555555555533
33455555555555555555555555555555555555555555555555555555555555555555555533
33333333333333333333333333333333333333333333333333333333333333333333333333
33333333333333333333333333333333333333333333333333333333333333333333333333
00000000333330000000000000000000000000000000000000000000000000000003000000
00000000000000000000000000000000000000000000000000000000000000000000000000
