00000000000000000000
00000000000000000000
00000000000000000000
00000000000000000000
00000000000000000000
00000000000000000000
00000000000000000000
00000000000000000000
00000000000000000000
00000000011110000000
00000000112210000000
00001111122210000000
00011222222210000000
00112222221110000000
00122222221000000000
01122222221000000000
01222222211000000000
01222221110000000000
01111111000000000000
00000000000000000000
