33300000
33300000
33300000
00000100
00001000
00011100
00000000
00000000
00000000
