00ddd0i000
00dd000800
0dd00k0000
dd0h0j000d
d00000000d
dg000000dd
d000j000dd
d0e000dddd
d0000ddddd
ddfddddddd


