00000000000000000000
00000000000000000000
00000000000000000000
00000000000000000000
00000000000000000000
00000000000000000000
00000000000000000000
00000000000000000000
00000000000000000000
00000000000000000000
00000444440000000000
00000444440000000000
00004444440000000000
00000444440000000000
00000444440000000000
00000000400000000000
00000000000000000000
00000000000000000000
00000000000000000000
00000000000000000000
