0000022222
0000222222
0002222222
0022222220
0222222220
0222222200
0222222200
0222220000
0222220000
0000000000


